111111111111111111111
10PC00000100000CCCCC1
111010010111000111CC1
10100K0E00C0000KKKKK1
111111111111111111111
